169 44 50 21
27 10 28 21
64 10 28 21
101 10 28 21
134 10 28 21
165 10 28 21
18 44 28 21
54 44 28 21
92 44 28 21
129 44 28 21